Noma	Lavelle
Carmelina	Scot
Raymonde	Renaldo
Rosemonde	Laureen
Elbertina	Torrie
Anamaria	Alfie
Jenda	Marquitta
Thea	Hwa
Vivianna	Julia
Anisa	Yevette
Eleanore	Hildegard
Christie	Lavette
Natacha	Santana
Hyacintha	Laureen
Danilo	Kelle
Gaylene	Albertina
Charlette	Tish
Hedwiga	Aracelis
Janet	Drucilla
Linell	Kala
Lesli	Masha
Hesther	Lovetta
Dulci	Loralee
Camel	Shanta
Merrielle	Charolette
Debee	Gelya
Delores	Sarai
Aracelis	Wei
Magdalen	Delores
Joycelyn	Cecilia
Vince	Jessamyn
Margalit	Lilyan
Brittne	Winna
Risa	Frederick
Dwight	Clotilda
Mitzi	Sosanna
Kevyn	Cybil
Carolann	Minnnie
Angelique	Dona
Lakiesha	Gabriele
Shelly	Leelah
Tamma	Susy
Olivie	Anastasia
Gabie	Angelena
Jacquelyne	Kena
Bren	Lebbie
Milda	Deandrea
Elbertine	Nikkie
Vyky	Jaynell
Brenton	Farah
Maddalena	Kristian
Albertine	Trixy
Cecilia	Natty
Kary	Matthew
Dennise	Christan
Jacquetta	Kessia
Ange	Christean
Gilemette	Sorcha
Rikki	Ted
Minh	Kecia
Lyssa	Loralee
Gerry	Berta
Annita	Ardra
Lesly	Oliva
Waylon	Florry
Auria	Sha
Christan	Cecille
Cinnamon	Anh
Pattie	Vicente
Belinda	Erina
Ricki	Melessa
Star	Bel
Trudi	Selle
Sunshine	Minette
Kaile	January
Marry	Jamar
Rivkah	Shir
Cristine	Mikel
Olen	Micha
Sherie	Sharolyn
Mickie	Elysia
Zoila	Jeannetta
Billy	Tommie
Marcile	Armand
Kindra	Tiara
Ailsun	Rivkah
Caralie	Tashia
Daria	Nestor
Olympie	Derek
Tierra	Antoine
Veta	Nedda
Caro	Jadwiga
Babita	Lyndon
Loise	Jenell
Brynne	Arleyne
Shalna	Arron
Lonee	Karole
Mariel	Sena
Conchita	Kalie
Tiff	Addi
Kelcie	Verine
Marigold	Pearla
Roberta	Margareta
Harry	Lajuana
Maragaret	Margherita
Leota	Tanika
Elwood	Bette
Valentina	Wendie
Veta	Georgie
Lincoln	Marty
Joannes	Lorelei
Sharleen	Dane
Fanchette	Joanne
Veola	Abigale
Pricilla	Kristian
Sharron	Cathey
Edy	Liz
Georgena	Flossy
Ina	India
Dyanne	Fredia
Gwenny	Jolynn
Galen	Kellie
Elonore	Shelley
Saundra	Laurence
Eilene	Catriona
Kasandra	Karena
Arron	Annalee
Roger	Deva
Mufi	Ashlen
Brynne	Agustin
Papagena	September
Mariquilla	Mureil
Lizbeth	Marleah
Mallory	Dorisa
Rebekah	Mia
Winnah	Shaneka
Loella	Britni
Meggan	Shelli
Shelby	Selma
Jolie	Maggie
Tawna	Daffy
Loella	Brandon
Georgeta	Marry
Chin	Lewis
Rivkah	Kendra
Rosana	Tamra
Denisse	Gavra
Gertha	Samatha
Audrie	Caitlyn
Tameika	Natty
Ines	Mia
Tiffi	Karee
Arden	Branden
Tina	Lynsey
Stacy	Kelsey
Lexis	Shaylah
Monah	Merla
Lanni	Arie
Caroljean	Aurie
Lexis	Un
Ericka	Leeanne
Lawrence	Fae
Eusebia	Natacha
Janaye	Kimber
Thekla	Willie
Alec	Ermengarde
Courtnay	An
Kaylil	Christean
Anja	Van
Parker	Sanjuana
Richie	Guenevere
Crystle	Lurette
Venetta	Guillemette
Valentina	Dalia
Sharron	Sima
Amanda	Roger
Jacquiline	Gwen
Claire	Rozalie
Collette	Darb
Adrianne	Laquita
Carmita	Brendan
Diana	Hee
Lera	Guy
Tiffie	Diamond
Evalyn	Masha
Su	Karolyn
Loris	Tanna
Rona	Ebonee
Emanuel	Deedee
Zulema	Jannie
Chloette	Abbi
Ileane	Irmgard
Vonni	Yettie
Ronnie	Gabriella
Latrena	Leola
Rina	Tammara
Steffie	Melodie
Papagena	Pattie
Fernanda	Manuela
Jessamine	Bambie
Ange	Corny
Rhett	Luanna
Matha	Page
Lari	Nerty
Caritta	Jobina
Ansley	Gail
Ilona	Tiffie
Shalon	Linsey
Nanni	Leanne
Binni	Bab
Mame	Sharai
Tama	Cassaundra
Terra	Nerita
Elfie	Paolina
Rudolph	Marcelle
Addi	Shyla
Martica	Thanh
Lisa	Davita
Alfred	Verine
Napoleon	Editha
Minne	Joelie
Kimi	Melanie
Brande	Joanne
Joane	Yanira
Janetta	Shaneka
Lynnelle	Jerrod
Boris	Deetta
Nickole	Joane
Deandra	Cherryl
Bradford	Deetta
Leroy	Wilhemina
Kerry	Marcia
Joell	Brynne
Florencia	Arminda
Cynthy	Vinnie
Rob	Elysia
Lebbie	Cate
Lacy	Laurel
Simonette	Aurilia
Pet	Shera
Faun	Graig
Jeannine	Estela
Carlye	Jasper
Nanni	Lorrayne
Cliff	Raychel
Shin	Charis
Celeste	Eilis
Jacky	Jaye
Lovetta	Gavra
Minne	Latina
Sharleen	Janith
Amity	Lisa
Laureen	Agustin
Amalee	Mattie
Cheri	Britta
Thomasin	Allix
Ahmad	Eddie
Corabella	Jeanmarie
Minna	Kriste
Cissy	Gilemette
Lore	Delma
Lauren	Layla
Evangelin	Milissent
Sidoney	Ignacio
Meg	Kasey
Magdaia	Shaylah
Brina	Idelle
Tiesha	Randy
Kristel	Bab
Storm	Jarrod
Franciska	Mitsue
Sina	Tiphanie
Evonne	Rosalynd
Sharai	Elizabet
Zackary	Sidonia
Bobine	Vivianna
Serita	Monique
Kiara	Minette
Ines	Chan
Calley	Anja
Pier	Agnola
Dalia	Fredericka
Brande	Lonna
Natacha	Jodi
Milicent	Cyndi
Mary	Franciska
Adelle	Tomeka
Marjorie	Melisandra
Sukey	Anjelica
Tonia	Ken
Aline	Etsuko
Cayla	Marrissa
Bong	Nettie
Dori	Marcellus
Sunshine	Collette
Divina	Reggi
Arthur	Greta
Wonda	Johnna
Astra	Stefan
Mozell	Sharita
Junia	Scot
Thomasa	Elora
Lanni	Ardelia
Santana	Dayna
Norbert	Fermin
Tamala	Esmaria
Aide	Karina
Nonah	Lynetta
Tiesha	Ghislaine
Denita	Barbi
Eustacia	January
Martha	Graham
Kortney	Jyoti
Velma	Oralla
Phillip	Galina
Natashia	Brina
Mui	Nonah
Joby	Leonanie
Alvinia	Kasey
Robbyn	Wilhelmina
Lakeshia	Nathalia
Matha	Heather
Jaqueline	Brigette
Melani	Chloette
Jenette	Chiquia
Shaylah	Lynnett
Anitra	Dorita
Carisa	Lebbie
Gina	Yanira
Beitris	Kellie
Robena	Cayla
Blinni	Erena
Dorris	Cuc
Shyla	Takako
Pasquale	Mallissa
Linsey	Prince
Elysia	Morganica
Carrie	Darius
Libbey	Feodora
Jobina	Raymonde
Jarrod	Arluene
Brande	Alisa
Linnell	Mada
Esther	Sanjuana
Jerri	Jaquith
Tallie	Leelah
Libbie	Jasmina
Harriott	Cherrita
Dalia	Chasidy
Hetty	Clemence
Wilbert	Donte
Tina	Gwenette
Whitley	Mikki
Lynette	Janean
Junior	Cloris
Liesa	Ula
Sherrell	Derick
Grata	Gigi
Sheela	Jessika
Sher	Terri
Beth	Verine
Cody	Marga
Corie	Kortney
Bobby	Roland
June	Jeanmarie
Jennell	Crissy
Charil	Leshia
Vittoria	Zara
Gnni	Sharie
Nakesha	Pris
Shawna	Merlina
Constance	Celena
Velva	Kamillah
Orella	Lurette
Caprice	Sorcha
Francisco	Gertha
Emerita	Hans
Kelcey	Fatimah
Louisette	Denny
Erina	Tyisha
Faye	Conception
Janean	Devonne
Cele	Thad
Vania	Leontyne
Davita	Lucio
Marylinda	Deva
Pearlene	Allena
Netty	Rueben
Hermine	Seymour
Lulu	Monnie
Milo	Lon
Earl	Lillie
Ninfa	Sabra
Dorthea	Sophey
Ivette	Reita
Chan	Zoila
Vennie	Christoper
Selma	Logan
Marcelle	Gail
Erline	Merlene
Scottie	Cherry
Theodore	Leanora
Giustina	Melani
Cliff	Alethia
Ellen	Adoree
Keven	Mackenzie
Anselma	Lorenza
Michaele	Chu
Lulu	Tiny
Denys	Cariotta
Xiomara	Kathryne
Drona	Troy
Homer	Leora
Torey	Vonny
Kiana	Ketti
Tia	Marrissa
Rori	Meris
Meghann	Aida
Sharilyn	Sherie
Carson	Kyra
Fae	Leonore
Carin	Lawrence
Lyla	Amira
Paulene	Carmella
Drusie	Abigale
Etha	Chieko
Jobina	Tish
Jackelyn	Genevie
Carin	Galen
Beryl	Catalina
Gwen	Cecile
Briny	Jayne
Terence	Yoshi
Lynette	Lily
Bellina	Roch
Jackquelin	Alba
Dwight	Roosevelt
Arron	Shayne
Viviene	Beret
Gilli	Lavelle
Diamond	Melinda
Sigrid	Paolina
Yettie	Drona
Carli	Allina
Kena	Matilda
Bernadine	Jerri
Tiffany	Tilly
Sallyanne	Berneice
Madalena	Dorris
Brenton	Austina
Nestor	Harrison
Arletha	Debee
Brian	Bettine
Tonette	Stacy
Maida	Beitris
Enda	Alba
Kourtney	Binnie
Tedra	Clotilda
Agustin	Gabbey
Linette	Sina
Gerti	Sisely
Pearlene	Kennith
Rea	Rafa
Judi	Maple
Brittney	Alishia
Julio	Tiesha
Lesley	Cecil
Tonita	Matha
Charlie	Wei
Nadia	Barbara
Gustie	Editha
Dean	Jennell
Evalyn	Ilse
Lucienne	Evy
Teresina	Abraham
Jim	Kaylene
Odetta	Isabelle
Destiny	Terry
Rasla	Rosanna
Cornelius	Yong
Angle	Leanora
Florry	Catriona
Brunhilda	Jonell
Frank	Reda
Garret	Santana
Ammie	Anabella
Otilia	Gwenny
Caterina	Jacky
Evey	Marin
Elliot	Natacha
Rachal	Sandee
Pok	Deetta
Valarie	Sherell
Yetty	Nanci
Ammie	Celestia
Elbertina	Myron
Franchesca	Alba
Matt	Vale
Dyan	Nevsa
Daniel	Samual
Karena	Blondie
Marth	Josey
Janine	Buster
Sybil	Ismael
Merna	Charmane
Shona	Jannie
Blair	Azucena
Pattie	Abigale
Penney	Tiffany
Zulema	Rina
Sherell	Meg
Willena	Ilene
Sabra	Junette
Alesia	Soila
Celia	Petrina
Suzy	Ted
Santana	Edy
Vernie	Meaghan
Georgiana	Nery
Denisse	Kasey
Jerrod	Alesia
Anjelica	Lakeshia
Flossy	Colleen
Stefan	Fina
Luise	Dayna
Jolanda	Maile
Carolann	Modesty
Kelcey	Gabbey
Sima	Winnah
Iliana	Robbyn
Cherise	Shelby
Sybil	Korry
Louvenia	Anabelle
Alyssa	Danice
Lavon	Shelba
Chiquia	Jennell
Allina	Jerry
Bren	Ira
Maida	Mariya
Juliette	Belinda
Alisa	Lajuana
Kermit	Kristina
Yu	Ria
Dyanna	Valentin
Fatimah	Mina
Idelle	Emili
Waylon	Beitris
Sena	Kendra
Julian	Tallia
Natty	Ilse
Kiley	January
Rene	Agustin
Sosanna	Dniren
Esther	Anjanette
Helyn	Shalonda
Danica	Meggi
Cody	Albertha
Alycia	Willian
Larhonda	Jane
Farrand	Dominga
Lucina	Catlee
La-verne	Adriene
Shin	Brunhilde
Garnette	Tamra
Olinda	Yanira
Lyla	Juditha
Elinor	Giulia
Bronwyn	Signe
Boris	Devina
Tami	Mariano
Minnnie	Season
Galen	Edmond
Alethia	Catarina
Davida	Gilemette
Amelie	Macie
Kesha	Jeanmarie
Bell	Fran
Ricky	Karan
Milagros	Farah
Drucy	Adela
Deandra	Annabal
Stepha	Aviva
Mireya	Carmelina
Peta	Keelia
Marsha	Hanni
Sigrid	Jazmin
Lilly	Loralyn
Addi	Sharmaine
Jarod	Porter
Lynette	Cecile
Deloria	Leeann
Jule	Roselyn
Christoper	Gwenneth
Tuyet	Rafa
Lavelle	Erasmo
Coralee	Caleb
Ki	Jamison
Tobie	Otto
Jerica	Tanika
Talisha	Tabina
Svetlana	Allen
Dusti	Merralee
Rani	Enda
Emil	Celesta
Adella	Marguerite
Brina	Judi
Angelita	Gerardo
Francisca	Sharita
Deanna	Mikki
Rozalie	Giulia
Yolanda	Noelyn
Cordie	Erena
Joelie	Fredrick
Aigneis	Clementina
Sandie	Papagena
Onita	Mari
Sherlene	Jordanna
Henry	Duane
Sharilyn	Linette
Gaylene	Zulema
Leif	Janyce
Flori	Darius
Shakia	Rici
Latina	Fionnula
Sheba	Mathew
Denae	Ericka
Su	Luanna
Esmaria	Loria
Kayce	Darius
Quintina	Jehanna
Eran	Bobby
Tyron	Carma
Junie	Bathsheba
Francisca	Corny
Carlena	Giorgia
Abra	Mariana
Thomasin	Piper
Seka	Jule
Guadalupe	Anabelle
Brittney	Marguerita
Tawanna	Karyl
Linell	Corie
Hetty	Daisey
Constanta	Ed
Elinor	Daffi
Ngan	Clara
Gilli	Roseanne
Shoshanna	Kaylene
Shelby	Corabel
Spring	Ulla
Lakeesha	Gene
Clementine	Aurilia
Akilah	Karole
Roby	Gabrila
Bernadine	Caroljean
Bert	Melisse
Alma	Lucille
Alpha	Deetta
Tabina	Ninnette
Brinna	Wandis
Greer	Dorette
Natalee	Krystle
Gaby	Angelita
Celinda	Jacqui
Belinda	Ilona
Hong	Stefan
Deloria	Colleen
Kathline	Tyesha
Margorie	Rhonda
Papagena	Rocio
Caressa	Mirian
Jaimie	Vince
Hillary	Gerardo
Vivien	Gwen
Lorianne	Germana
Santa	Sharona
Leeann	Elva
Minh	Melodee
Olympie	Bessy
Trudie	Dino
Serene	Jaynell
Iliana	Moshe
Demetra	Shawnda
Janith	Eleonora
Matilda	Birgit
Becka	Vonny
Lera	Tuyet
Maryrose	Shawnda
Ofelia	Dorice
Virgil	Dwana
Abra	Sabine
Tedra	Quentin
Duane	Ralph
Torri	Trenna
Nettle	Johnson
Josefa	Junina
Jessamine	Rea
Mirilla	Heidie
Manual	Mikki
Leeanne	Lyssa
Everett	Karena
Sosanna	Anjanette
Gregg	Kellee
Petrina	Lauralee
Tiny	Gilberta
Aeriell	Aigneis
Esmaria	Stephnie
Valentin	Florette
Don	Christa
Mavis	Constancia
Eilene	June
Eleonora	Jena
Danuta	Aretha
Basia	Pavla
Basia	Kendra
Nicola	Laquanda
Deva	Elset
Rivkah	Daisi
Anh	Deandrea
Rhiamon	Adorne
Darnell	Leilah
Abbey	Hoyt
Thia	Melda
Evalyn	Clelia
Leeanne	Marybelle
Sarita	Michaella
Heddi	Audra
Jaye	Tabby
Tamarra	Gabbi
Louvenia	Genevive
Cassandre	Elysha
Manuela	Tijuana
Modesty	Guenevere
Columbus	Davita
Mikel	Ailene
Constance	Ernesta
Zulema	Dennise
Mattie	Chan
Quyen	Paloma
Vasiliki	Daryn
Mair	Ozell
Lindy	Chuck
Steve	Aigneis
Lashon	Jacquetta
Nettle	Genna
Raymonde	Roselyn
Bart	Etsuko
Catherin	Marcile
Elfreda	Rosalyn
Catarina	Shera
Channa	Lorette
Bab	Marquita
Rudolph	Catriona
Leoline	Karol
Bonnee	Samaria
Inge	Gerianne
Antonina	Alfreda
Sunday	Daniele
Margarethe	Hannis
Yoshie	Jackelyn
Kerri	Emmaline
Sharline	Cordelia
Peri	Pauli
Sherita	Blondell
Tiffaney	Daisey
Jayna	Sergio
Ngan	Carson
Yanira	Honoria
Belita	Louvenia
Leonore	Deanna
Emylee	Datha
Lanny	Precious
Elbertine	Natala
Bennie	Merna
Constance	Thresa
Despina	Myesha
Christina	Chin
Hallie	Bobbee
Lindy	Domini
Thad	Charmine
Fransisca	Stephane
Carry	Cayla
Catharina	Patria
Vennie	Taffy
Ngan	Vallie
Kelsey	Jeanmarie
Ansley	Sparkle
Ricca	Shandee
Cynthia	Dominque
Melda	Phylys
Tamala	Lizabeth
Bambie	Sherri
Pattie	Karia
Reita	Ayanna
Brady	Andee
Nichole	Tiara
Tina	Xiomara
Grisel	Marcile
Jeanmarie	Madel
Evy	Kellie
Carlynn	Mirian
Trena	Soon
Corny	Juana
Yoshi	Rina
Caty	Melony
Junette	Yoshie
Jori	Xylia
Jacquenette	Ethelyn
Mario	Del
Zackary	Morissa
Lynwood	Sandie
Melani	Warner
Marilin	Rebecka
Ethelin	Lannie
Maryanna	Charlette
Natacha	Kesley
Santa	Brenn
Cinnamon	Shalonda
Bab	Camel
Rozalie	Gaylene
Ilyssa	Anetta
Arleyne	Adelind
Ira	Golden
Clemence	Judi
Sanjuana	Sharlene
Roxann	Elenora
Sunday	Kriste
Carlota	Violette
Wilmer	Loris
Kayce	Deidra
Ekaterina	Moina
Katherin	Malynda
Armand	Andres
Danial	Junina
Kasha	Mittie
Noami	Chrysler
Bird	Matilda
Thad	Lorette
Pollyanna	Sondra
Allx	Alis
Martita	Yer
Karena	Marketa
Dyanne	Merrilee
Elonore	Steffane
Irita	Carson
Carolann	Renae
Lyssa	Dacia
Donte	Matha
Dacy	Charleen
Herminia	Roger
Pasquale	Lenore
Maritsa	Amy
Malynda	Colton
Cristine	Hortense
Fawne	Erwin
Zoila	Tula
Antonie	Trinh
Shawanda	Jama
Raphael	Mark
Roobbie	Nananne
Melli	Perri
Esmaria	Giovanni
Stevana	Velma
Nona	Morissa
Meri	Britta
Duane	Kasey
Georgianna	Oliva
Berget	Ivana
Stasia	Alfreda
Tristan	Brenn
Jorie	Lyndy
Jenise	Margareta
Loella	Clara
Ruby	Keira
Corny	Shaylah
Dessie	Luba
Lisa	Warner
Delphinia	Elvira
Martica	Kaylene
Marhta	Mureil
Heather	Arie
Ranee	Aida
Karlee	Talia
Zackary	January
Shena	Alleen
Aliza	Teddy
Drucy	Cordie
Mair	Theadora
Lesley	Moina
Jerri	Emelita
Miki	Debera
Reagan	Clemence
Shaneka	Mariana
Deanna	Evy
Melvina	Jarvis
Trinh	Lexy
Rosalynd	Aurora
Makeda	Reita
Ealasaid	Eilis
Ignacio	Sharai
Chiquia	Vale
Meta	Graham
La-verne	Britney
Lorenza	Henry
Stefan	Melisse
Chloris	Ericha
Francisca	Lianne
Melinda	Pearla
Maryrose	Roselyn
Vanesa	Bert
Kisha	Quentin
Rica	Susan
Wei	Daisy
Terry	Renae
Sal	Horace
Evanne	Hedwiga
Napoleon	Yuonne
Wonda	Maribelle
Jemimah	Emil
Ashli	Randy
Ada	Gianna
Tamekia	Brenton
Arleta	Zola
Becka	Joane
Jacquenette	Aubrey
Sheelagh	Valry
Scottie	Jeannette
Joela	Dalia
Christoper	Noe
Eilis	Athene
Neil	Linh
Adela	Hetty
Kakalina	Caressa
Eustolia	Eliana
Tobye	Allison
Candyce	Norry
Jenifer	Veda
Neil	Davine
Cliff	Fionnula
Napoleon	Mistie
Johnetta	Gwen
Evangeline	Lydia
Eladia	Stefan
Beitris	Mel
Delphinia	Philomena
Theodosia	Gayle
Lexy	Minette
Derek	Augustus
Delaine	Tina
Mickie	Kerrill
Meggy	Nerita
Brietta	Edy
Gricelda	Tonia
Kenda	Dorisa
Roby	Elsie
Brenton	Marlena
Dane	Shaine
Kina	Coralie
Ara	Merilyn
Patience	Arnetta
Etsuko	Stacy
Alexis	Elbertine
Dorice	Jandy
Florette	Arie
Otto	Lavelle
Clarita	Jamison
Dominga	Tiesha
Thia	Karleen
La-verne	Agustin
Quinta	Julius
Soraya	Lindy
Evita	Joline
Deadra	Celie
Olly	Marquitta
Athena	Genia
Cliff	Giulietta
Maighdiln	Ada
Marie-ann	Neil
Tomeka	Shelli
Parthenia	Tobye
Stormie	Debbie
Sophey	Matilda
Lawanna	Hyacintha
Marla	Jordanna
Mary	Dallas
Elfrieda	Vonny
Melda	Gabriella
Kristan	Giuseppe
Elease	Myong
Dona	Cathey
Terry	Pauli
Aridatha	Ellette
Gregg	Melda
Lynnette	Melanie
Dyan	Samatha
Barrett	Lorrin
Bobbette	Anny
Rene	Evalyn
Lino	Ilene
Sena	Roselle
Carlyn	Monique
Evy	Mia
Mina	Jyoti
Hosea	Lyndel
Andeee	Jesusita
Florette	Meda
Angila	Josefa
Kasi	Jaquelyn
Cassaundra	Regenia
Goldie	Gus
Alishia	Trena
Georgena	Elka
Sima	Alisa
Johnetta	Brittne
Herb	Elden
Jessamine	Darwin
Lupe	Lyndsay
Ivory	Tamarah
Sharolyn	Mellisent
Kirstin	Janell
Boris	Rhonda
Brandon	Zoila
Tracy	Evon
Terry	Brande
Mina	Rosario
Wilmette	Heidie
Debor	Amity
Delana	Jourdan
Helena	Bernardine
Ashli	Godiva
