Charlette	Missie
Wileen	Mommy
Lucius	Barbette
Timmy	Alaina
Lon	Stafani
Billy	Isa
Antonella	Papagena
Shizue	Evan
Fatimah	Harlan
Glory	Agretha
Kellia	Tiphani
Viviene	Sherlene
Marjory	Phebe
Fredda	Joelynn
Herschel	Missie
Diahann	Nga
Linea	Enid
Merilee	Elset
Dorotha	Eliz
Terry	Andie
Dione	Gino
Garnette	Alison
Marianna	Dorotha
Filomena	Marco
Kimberly	Rebbecca
Amelina	Yahaira
Ernestine	Angelique
Meggi	Lewis
Hilaria	Chelsea
Gino	Enid
Lewis	Norah
Vashti	Murial
Glory	Ferdinand
Ardelis	Viva
Winston	Rasla
Cathee	Enid
Sonnnie	Miriam
Alison	Billy
Angelique	Fatimah
Devon	Billy
Rosenda	Angelique
Morna	Kathi
Marco	Wilber
Tabetha	Fredda
Marjory	Dorotha
Morgan	Loma
Tanhya	Debera
Marianna	Sharai
Renda	Johanna
Umeko	Herschel
Alfonzo	Angelique
Wayne	Barbette
Donielle	Diane-marie
Glory	Marylyn
Linea	Margarett
Antonella	Shera
Loma	Zena
Alison	Yahaira
Devona	Angelique
Phebe	Jamey
Donielle	Tawna
Wayne	Rosenda
Keslie	Tanhya
Barbette	Tommie
Lorrie	Timmy
Xuan	Asa
Angelique	Drucill
Noell	Marylyn
Stacey	Kary
Brita	Gino
Lon	Marylyn
Lorrie	Oliver
Billy	Alexandra
Lavinie	Timmy
Stevana	Lasonya
Drucill	Juieta
Cheryll	Essy
Maribeth	Wileen
Marylyn	Rosette
Jamey	John
